CCCCCCCCCCCCCCCCCCCC
L                  R
L                  R
L                  R
L                  R
L                  R
L                  R
L                  R
L                  R
L                  R
L                  R
L                  R
L                  R
L   S         G    R
FFFFFFFFFFFFFFFFFFFF
CCCCCCCCCCCCCCCCCCCC
L                  R
L                  R
L                  R
L                  R
L                  R
L                  R
L                  R
L                  R
L                  R
L       RL         R
L       RL         R
L       RL         R
L   S   RL   G     R
FFFFFFFFFFFFFFFFFFFF
CCCCCCCCCCCCCCCCCCCC
L      L           R
L      L           R
L      L           R
L      L           R
L      L           R
L      L           R
L                  R
L                  R
L                  R
L       FF         R
L       RL         R
L       RL         R
L   S   RL   G     R
FFFFFFFFFFFFFFFFFFFF
CCCCCCCCCCCCCCCCCCCC
L      LRRRRRRRRRRRR
L      LRRRRRRRRRRRR
L      L           R
L      L           R
L      L           R
L      LG          R
L                  R
L                  R
L                  R
L       FF         R
L       RL         R
L       RL         R
L   S   RL         R
FFFFFFFFFFFFFFFFFFFF
CCCCCCCCCCCCCCCCCCCC
L         CC       R
L         CC       R
L                  R
LG   L     RR      R
LLLLLL     R       R
L         RRRRRRRRRR
L                  R
LLLLL              R
L           RR     R
L            RR    R
L             RRRRRR
L  FFFFF           R
L  FFFFFFFF   S    R
FFFFFFFFFFFFFFFFFFFF

